..#################################################################################################
..#...#.........#.....#...#.....#...#...#.....#...#...#.#...#.............#.#.....#.....#.#.#.....#
#.#.###.###.#.#.#####.#.#######.#.###.#####.#####.#.#.#.###.#######.#.###.#.###.#.###.###.#.#####.#
#...#.#...#.#.#...#...#...#.......#.#.....#...#...#.#...#...#.......#.#.#.......#.#.#.............#
###.#.###.#.#####.#.#.#.###.#.#.#.#.#.#.###.#.#.###.#.#####.#.###.#####.#.#######.#.#.#.###.###.###
#.........#.#...#...#.......#.#.#.#.#.#.....#.#...#.#...........#.#.........#...#.#.#.#...#.#.#.#.#
#.#####.#.###.#.#####.#########.###.###.#######.#.#####.###################.#.#.###.#.#######.#.#.#
#.....#.#.#...#.......#...#.....#...#.#.........#.....#...#.....#.#...#.....#.#...#.....#.#.#.....#
#####.#####.#####.#.###.#########.###.#.#.###.#######.#######.###.#.#.#.###.#####.#.#####.#.#.###.#
#...#.....#.....#.#...#...#.#.#.#.....#.#.#.........#...#.....#.....#.....#...#.#.#.#.....#.#...#.#
#.#######.#########.#.#.###.#.#.#.#####.#####.#########.#.#.###############.###.#.#.#.#####.###.###
#.#.#.#.........#...#.....#.#...#...#.#.#...#.#.......#.#.#.....#.#...#.#.#...........#.......#.#.#
#.#.#.#############.#.###.#.###.###.#.#.#.#.#####.#.###.#.###.###.###.#.#.#######.###.###.#.#.#.#.#
#.#...#.....#...#...#...#.......#...#.....#.#.....#...#...#.....#...#...#.#.#.#.#...#.#...#.#.....#
#.###.#.###.###.#.#####.#.###.###.###.###.#.#.###.#.#.#########.###.#.###.#.#.#.#.#######.#######.#
#.........#...#.#...#...#.#.....#...#.#.#.#.....#.#.#.#.........#.....#.......#.#.#.#.#...#.....#.#
#.#.###.#######.#.#.#######.#.#.#.###.#.#####.#######.#############.#.#.#.#.###.###.#.###.#####.#.#
#.#...#.#.......#.#.#.#.....#.#.#...#.#.......#.........#.......#.#.#.#.#.#...#.#...#.#.#.#.......#
###.###.#.###.#.#.###.#.#####.#####.#.###########.###.#.#####.#.#.#.#####.###.#.#.###.#.#####.#.#.#
#.#.#.#.#.#...#.#.#...#.#.....#.....#.....#...#.#...#.#.#.....#.#...#.....#.......#.#.#.....#.#.#.#
#.###.#.#.###########.#.###.###.#####.#####.#.#.###.###.#####.###.#.#.#.#####.#####.#.#.#####.#####
#...#.#.....#...#...#...#...#...#.....#...#.#...#.....#...#.......#...#.#...#.#.............#.....#
#.###.#.###.#.###.###.#.#.#.#.#######.###.#####.###.#.###.#.#.#.#.###.#####.#########.#########.###
#.......#.#.#...#.....#.#.#.....#.#.....#.....#...#.#...#...#.#.#...#.#...#.#.#.#.....#...........#
###.###.#.#.#.#.#.#.#####.#####.#.#######.#.###.#.###.###.#.#############.#.#.#.#####.#.###.#.#.###
#.....#.#.....#.#.#.#.#...#.....#.........#...#.#.#...#...#.#...#...#.#.......#...#.....#.#.#.#.#.#
#.#####.#.#.#.#######.###.###.#.#.#.###.#######.#.#.#######.#.#####.#.###.#######.#######.###.#.#.#
#.#...#.#.#.#.....#.........#.#...#...#.#.......#.....#.....#.#...#.........#.......#.......#.#...#
###.###########.#####.#########.#.###.#######.###.#####.###.#.#.#.#####.#.#.#.#.#.###.#.###.###.###
#.#.#.....#.....#.#.#.......#...#.#.............#.#...#...#...#.#.#.....#.#.#.#.#.....#.#.........#
#.#.#####.###.###.#.#####.#.#.###.#.#.###########.#.###.#####.#.#.###.#####.#.###############.#.###
#...#.#.....#...#.#.#...#.#.#...#.#.#...#...#.......#...#.......#.#.......#.#...#.......#.....#...#
#.###.###.###.#.#.#.###.#####.#.#######.#.#####.#.###.#.#####.#####.#.#.#.#.#.#.###.#####.#######.#
#.....#.#.#.#.#.#.........#.#.#...#.....#.#...#.#...#.#...#.........#.#.#.#...#.#...........#.....#
###.###.#.#.###.#.#####.###.#############.#.###.###.###.###.###############.###.###.#.#######.#####
#.........#...#...#.......#...#...#.....#.#.....#...#...#.#.#...........#.#.#.#...#.#...#.#.......#
#.###.###.#.#############.###.#.###.#.###.###.#####.#.###.###.#####.#####.#.#.#.###.#.###.#######.#
#...#...#.#.#.#...#.......#.#...#...#.#.#.....#.#...#.#.#.#...#...#...#.#...#.#.#.#.#.#.#.......#.#
#.###.#.###.#.#.#######.#.#.###.#.###.#.#####.#.#.###.#.#.###.#.#.#.###.#####.#.#.#####.#.###.#.#.#
#...#.#.....#.......#.#.#.#.........#...#.....#.....#...#.#...#.#.......#...#.#.#...#.#...#...#.#.#
#.#####.###.###.#####.#.#.###.#########.#########.#####.#.#.#########.#.###.#.#.#.###.#########.#.#
#.....#...#.........#.#.#.#.....#...#.#.#.#.#...#.#.#.......#.#...#...#.#.....#.#...........#.#...#
###########.#.#.#####.###.#######.#.#.#.#.#.###.###.#.#.#####.###.###.#.#####.#.###.#####.###.###.#
#...#...#.#.#.#...........#...#.#.#...#.#...#...#.....#.....#.........#.#...#.#.#.#.#.......#.....#
#.###.###.###.#####.###.#.#.###.###.#.#.###.###.#.#####.#######.###.#######.#.###.###.###.###.###.#
#.#.#.....#...#.#...#...#.#.........#...#.....#.#.#.......#.#...#.....#...#.#.#.#...#.#...#.#.#...#
#.#.###.#.###.#.###.#.#.#######.#.#.#.###.#####.#.#.#######.###.#######.###.#.#.#.###.#####.#####.#
#...#.#.#...#...#...#.#.....#...#.#.#...#.....#.#.#.#.....#.#.#...#.#...#...................#.....#
#.###.###.#####.#.#.#######.#.#.#######.#.###.#.###.#####.#.#.###.#.#.#######.#####.#.#####.#.#.#.#
#.#.#.....#...#.#.#.#...#.#...#.#...#...#...#...#...#.#.#.#.#.#.......#.........#.#.#.#.....#.#.#.#
#.#.#####.#.#.#######.###.#.#.#####.###.###.###.#.#.#.#.#.#.#.#######.#####.#####.#.#.#####.#.#.#.#
#.........#.#.#.#.........#.#...#...#.......#.....#...#.....#.#.........#.#...#.#...#.#.#.....#.#.#
#.#.#.#.#####.#.###.#.#####.#####.#####.#.#######.#######.#.#.#.###.###.#.#.###.#######.#.#########
#.#.#.#.....#.#.....#...#.....#...#.#.#.#.....#.....#.#.#.#...#.#.....#...#...#.#.......#.......#.#
#######.###.#.#.#.#.#######.#.#.###.#.#.#.#.#.#####.#.#.#####.#.###.#####.###.#.#.###.#.#.#.###.#.#
#.#.#...#.#.....#.#.....#.#.#.....#...#.#.#.#...#.....#...#.#...#.#...#.#...#.#.#...#.#.#.#.#...#.#
#.#.#.###.#######.#######.#.#.#######.###.###########.#.###.#.###.#.#.#.#.#####.#####.###.###.#.#.#
#...#.....#...#.........#...#.#.....#.#.......#...#.........#.#...#.#.#.#...#...#.....#...#...#...#
#.###########.###.#########.###.#####.#########.###.###.#####.#.#.#####.#######.###.#############.#
#.....#...............#...#.........#.......#.#.#.#...#...#.#...#.#.#...#.#...#.....#.............#
#.#.###########.###.###.#.###.###.###.#######.#.#.#########.###.###.###.#.#.#.#####.#.#.#.#####.###
#.#.........#...#.....#.#.....#.#...............#.................#...#.....#.........#.#.#...#.#.#
###.#.#.#####.###.#####.###.###.#######.###.#.#.###.###.#.#.#.#.#####.#.###.###.#######.###.#####.#
#.#.#.#.....#.#.......#...#.#.............#.#.#.#...#.#.#.#.#.#.....#.#...#...#.....#.............#
#.###.#######.###.###.#######.#.#.###.#.###.#########.#########.###.#.###.#############.#####.###.#
#.....#.......#...#.#...#.#.#.#.#.#.#.#.#...........#.............#.....#.#.....#.....#.....#.#...#
###.#.###.#######.#.#####.#.#####.#.#########.#.#####.#.###############.#####.###.#####.#.###.#.#.#
#.#.#.#.#.#.....#...#.#.#...#...#.....#...#...#.#.....#...#...#.#...#...#.......#...#.#.#.#...#.#.#
#.###.#.#.#.###.#.#.#.#.#.###.#.#.#.#####.#.###.###.#####.#.#.#.#.#####.#.#####.#.###.###.#########
#.#.#.#.#.....#.#.#.........#.#...#.#.#.#...#...#.....#.#.#.#.........#...#.#.....#...#.......#...#
#.#.#.#.#####.###.#####.#######.#.###.#.#########.#.###.#.#.#########.###.#.#####.#.#.#####.#####.#
#...#...........#.#...#.........#.....#.........#.#.#...........#...#.#...#.....#.#.#.#.#.....#...#
###.#.#####.#.#.#####.#.#.#####.#########.###.###########.#####.#.#####.###.#####.#.###.###.#.###.#
#...#.....#.#.#.#...#...#.....#.....#.....#...#.......#...#.#.....#.#.....#.....#.....#...#.#.....#
#.###.###.###.###.#.###.###.#.#.###.#.###.#.#####.###.#.#.#.#####.#.#########.###.#.###.###.#######
#.....#.....#.#...#...#...#.#.#.#...#.#...#...#.....#...#.......#.#.#...#...#...#.#.#.#...#...#.#.#
#.###.#######.#.#######.#.###.###.#####.#.###########.#####.#####.#.#.#####.###.#####.#.#.#####.#.#
#...#.#.#.#...#...#.....#.#...#.......#.#.#.#...#.........#.#.....#.....#.#.#.#.#.......#...#.#...#
#.#####.#.#.###.###.#######.#.#####.#.###.#.###.#######.#.###.#########.#.#.#.#.#.#######.###.#.#.#
#.#...........#.#.#.....#.#.#.#...#.#.#...#...#.#.#.....#.#.........#...............#...#.#.....#.#
#.#######.###.#.#.###.###.#.#.#.#.###.#.###.###.#.#####.#####.#.#.#.#.#####.#.###.###.###.#.###.#.#
#...#.#...#.....#.#...#.....#.#.#...#.#.......#.....#.....#...#.#.#...#.....#...#...#.#.#...#...#.#
#.###.###.#.#####.###.#####.###.#.#.#.###.#####.#####.#.###############.###.#####.#.#.#.#.###.#.#.#
#...#...#.#.....#.......#...#...#.#.#.#.#...#.........#.........#...#...#.#.#.#...#.....#.#...#.#.#
#.#.#.###.#######.#####.#####.###.#.###.###.#####.#####.#########.#####.#.###.#.#####.#####.###.#.#
#.#.#.........#.#.#.....#...#.#...#.....#.#...#.....#...#...#.....#.........#.#.....#.#.#.#...#.#.#
#.###.#####.###.###########.###.#########.###.#.#.###.#.#.#.#.###.#####.#####.#####.###.#.#####.###
#.#.#...#.#.....#.....#.....#.....#...#...#.....#...#.#...#.#...#...#.#...#...#.#.#.....#...#.#...#
###.#.###.#.#.#.#.#.#.#.#.#####.###.###.###########.#####.#.###.#.#.#.#####.###.#.#.###.#.###.###.#
#.....#.....#.#.#.#.#.#.#...#...#.......#.....#.........#.#.#...#.#.#...#.#.#...#.#.#.....#...#...#
#.###.###.#####.#.###.#.#.#####.#.#####.#.#########.#.#####.#####.###.###.#.#.#.#.#.#####.###.###.#
#...#.#.#.....#.....#.#.#.....#.......#.#.....#...#.#...#.#.#.....#.....#.#.#.#.........#.#...#...#
#.#.#.#.###.#.###.#.#.#######.#####.#.#.#.###.#.###.#.###.###.###.#.#####.#.#.#####.#####.#.#####.#
#.#.#.#...#.#.#...#.#...#.....#...#.#.#...#...#.#...#.....#...#.#.......#...#.#.....#.#.#...#...#.#
#######.#.#.#####.#####.#.#.###.#.#.###.#.#.###.#.#####.#######.#####.###.#########.#.#.#.#####.#.#
#.......#...#...#.....#.#.#.#.#.#.#.#...#.#.......#.......#.#.............#.......#.....#...#.#...#
#.#.#.#####.###.#.#####.#.#.#.###.###.###.#########.#.#####.#.#.#######.###.###########.#####.#.###
#.#.#...#...#.........#.#.#.............#...#.......#.......#.#...#...........................#....
#################################################################################################..